###################################
#                      #   #      #
#     ################ ####       #
#     #              # #    ### # #  
#     #############  # #      # # #
#                 #  # ######## ###
#####  ### ########  #            #
#  ##    # #         ##############
#  ##    # #                    # #
#   #    # #                    # #
#   ###### ###################### #   
#                                 #
###################################